
SO ./textures/south.xpm
    C    0 0 255

      R  700 700

NO ./textures/north.xpm

EA ./textures/east.xpm

 WE ./textures/west.xpm



S ./textures/pillar.xpm


F 255 0 0
111111
1S0001
10 001
100011
111111
