R 1920 1080
NO ./textures/north.xpm
EA ./textures/east.xpm
WE ./textures/west.xpm
SO ./textures/south.xpm


F 220,100,0 		
C 225,30,0		
  
		

 

111111111111
111001110111
110000000011
11N000110111
111111111111
