SO ./textures/south.xpm



R 1000 700

NO ./textures/north.xpm
EA ./textures/east.xpm
WE ./textures/west.xpm



S ./textures/pillar.xpm ascasc 


F 255      100        0 		
C 0        ,,,    255,,,  255		
  
		

 

1111111
 100N01
11121111
11111111 