R 1920 1080
NO ./tests/maps/textures/wool_colored_light_blue.xpm
SO ./tests/maps/textures/wool_colored_lime.xpm
WE ./tests/maps/textures/wool_colored_red.xpm
EA ./tests/maps/textures/wool_colored_yellow.xpm
S ./tests/maps/textures/pillar.xpm
F 220,100,0
C 225,30,0
1111111111111
1000011111011
11N0000000001
1111110011111
1111111111111
